...###......
..##.#.####.
.##..###..#.
##........#.
#...@..#..#.
###..###..#.
..#..#....#.
.##.##.#.##.
.#......##..
.#.....##...
.#######....